1111111
10000E1
1CC0001
1111001
11E1P01
1111111