1111111
1000001
1CC0001
1101001
11E1P01
1111111