111111111111
10000010C001
1C1000100001
1C1000100001
1C1000100001
1C1000000101
11E001PC1001
111111111111