11111111
1001E001
10CC0001
10000P01
10000001
11111111