11111111111111111
100C0011000000001
10000000000111001
10000000000111001
100000000000C0001
1000000001P100001
10000000011100001
1000E000000000C01
10000000000000001
11111111111111111